1111111111111
10C000100C001
1000C010C0001
1P000010000E1
1111111111111
