1111111111111111111111111111111111
10011E000000000000000000000C000001
1001111111111100000000000001111001
1001100000000000001111111110000001
1001100000000000001111110000000001
10011000000000000000C1110000000001
1001100001111000000001110000000001
1001100001110000000001110000000001
100110000110000000000000000C000001
100000000000000000C000000111111111
1P00110000000000000000011111111111
1111111111111111111111111111111111