111111111111111111111111111111
100001111100000000000000000001
100001111100000000011100000001
10000111110000000001C100000001
100001111100000000011100000001
100001111100000000000000000001
100001111100000000000000000001
1000011111000000000000E0000001
1PC0000000000000C0000000000001
111111111111111111111111111111
